g g 0 0 0 0 0 0 0 0 0 0 0 0 0 0 0 0 0 0 0
g g 0 0 0 0 0 g g g g g g g g g 0 0 0 0 0
g g 0 0 0 0 0 g g 0 g g g g g g 0 0 0 0 0
g g g g g g g g g 0 g g g ge g g 0 0 0 0 0
g g g g g g g g g 0 g g g g g g 0 0 0 0 0
g g 0 b b b 0 g g g g g g gp g g 0 0 0 0 0
g g 0 0 0 0 0 g g g g g g g g g 0 0 0 0 0
0 0 0 0 0 0 0 0 0 0 0 0 0 0 0 0 0 0 0 0 0
0 0 0 0 0 0 0 0 0 0 0 0 0 0 0 0 0 0 0 0 0
0 0 0 0 0 0 0 0 0 0 0 0 0 0 0 0 0 0 0 0 0
0 0 0 0 0 0 0 0 0 0 0 0 0 0 0 0 0 0 0 0 0
0 0 0 0 0 0 0 0 0 0 0 0 0 0 0 0 0 0 0 0 0
0 0 0 0 0 0 0 0 0 0 0 0 0 0 0 0 0 0 0 0 0