0 0 g g g 0 g g g g g g g g g g g g g g g g g g g g g g g g g g g g g g
0 0 g g g 0 g g g g g g g g g g g g g g g g g g g g g g g g g g g g g g
0 0 g g g 0 g ge g g g g g g g g g g g g g g g g g g g g g g g g g g g g
0 0 g g g 0 g g g g g g g g 0 0 0 0 0 0 0 0 g g g g g 0 0 0 g g g g g g
0 0 g g g 0 g g g g g g g g 0 0 0 b b b b g g g g g g 0 0 0 g g g g g g
0 0 g g g 0 g g g g g g g g 0 0 0 b b b b 0 g g g g g 0 0 0 g g g g g g
0 0 g g g 0 g g g g g g g g 0 0 0 b b b b 0 g g g g g 0 0 0 g g g g g g
0 0 g g g 0 g g g g g g g g 0 0 0 b bp b b 0 g g g g g 0 0 0 g g g g g g
0 0 g g g 0 g g g g g g g g 0 0 0 b b b b 0 g g g g g 0 0 0 g g g g g g
0 0 g g g 0 g g g g g g g g g g 0 0 0 0 0 0 g g g g g 0 0 0 g g g g g g
0 0 g g g 0 g g g g g g g g g g g g g g g g g g g g g 0 0 0 g g g g g g
0 0 g g g 0 g g g g g g g g g g g g g g g g g g g g g 0 0 0 g g g g g g
0 0 g g g 0 g g g g g g g g g g g g g g g g g g g g g 0 0 0 g g g g g g
0 0 g g g 0 g g g g g g g g g g g g g g g g g g g g g 0 0 0 g g g g g g
0 0 g g g 0 g g g g g g g g g g g g g g g g g g g g g 0 0 0 g g g g g g
0 0 g 0 0 0 g g g g g g g g g g g g g g g g g g g g g 0 0 0 g g g g g g
0 0 g 0 0 0 g g g g g g g g g g g g g g g g g g g g g 0 0 0 g g g g g g
0 0 g 0 0 0 g g g g g g g g g g g g g g g g g g g g g g g g g g g g g g
0 0 g 0 0 0 g g ge g g g g g g g g g g g g g g g g g g g g g g g g g g g
0 0 g 0 0 0 g g g g g g g g g g g g g g g g g g g g g g g g g g g g g g
0 0 g 0 0 0 g g g g g g g g g g g g g g g g g g g g g g g g g g g g g g
0 0 g 0 0 0 g g 0 0 0 0 0 g g g g g g g g g g g g g g g g g g g g g g g
0 0 g 0 0 0 g g 0 0 0 0 0 g g g g g g g g g g g g g g g g g g g g g g g
0 0 g 0 0 0 g g 0 0 0 0 0 g g g g g g g g g g g g g g g g g g g g g g g
0 0 g 0 0 0 g g 0 0 0 0 0 g g g g g g g g g g g g g g g g g g g g g g g
0 0 g 0 0 0 g g 0 0 0 0 0 g g g g g g g g g g g g g g g g g g g g g g g