g ge 0 0 0 0 0 0 0 0 0 0 0 0 0 0 0 0 0 0 0
g g 0 0 0 0 0 g g g g g g g g g 0 0 0 0 0
g g 0 0 0 0 0 g g 0 g g g g g g 0 0 0 0 0
g g g g g g g g g 0 g g g g g g 0 0 0 0 0
g g g g g g g g g 0 g g g g g g 0 0 0 0 0
g g 0 b b b 0 g g g g g g g g g 0 0 0 0 0
gp g 0 0 0 0 0 g g g g g g g g g 0 0 0 0 0
0 0 0 0 0 0 0 0 0 0 0 0 0 0 0 0 0 0 0 0 0
0 0 0 0 0 0 0 0 0 0 0 0 0 0 0 0 0 0 0 0 0
0 0 0 0 0 0 0 0 0 0 0 0 0 0 0 0 0 0 0 0 0
0 0 0 0 0 0 0 0 0 0 0 0 0 0 0 0 0 0 0 0 0
0 0 0 0 0 0 0 0 0 0 0 0 0 0 0 0 0 0 0 0 0
0 0 0 0 0 0 0 0 0 0 0 0 0 0 0 0 0 0 0 0 0